32
24
00000000000000000000000000000000
00000000000000000000000000000000
00000000000000000000000000000000
00000000000000000000000000000000
00000000000000000000000000000000
00000000000000000000000000000000
0000000##################0000000
0000000#3..............1#0000000
0000000#########.########0000000
0000000#########.########0000000
0000000#########.########0000000
0000000#2.......s.......#0000000
0000000#########5########0000000
0000000#########.#4.....#0000000
0000000#########.######.#0000000
0000000#................#0000000
0000000##################0000000
00000000000000000000000000000000
00000000000000000000000000000000
00000000000000000000000000000000
00000000000000000000000000000000
00000000000000000000000000000000
00000000000000000000000000000000
00000000000000000000000000000000