32
24
00000000000000000000000000000000
00000000000000000000000000000000
00000000000000000000000000000000
00000000000000000000000000000000
00000000000000000000000000000000
00000000000000000000000000000000
000000000###############00000000
00000000#...............#0000000
0000000#.1...............#000000
000000#...................#00000
00000#....##.........##....#0000
0000#.....##.........##..2..#000
000#.........................#00
000#.........................#00
000#............s............#00
000#............#............#00
000#............5............#00
0000#.......................#000
00000#...#...........#.....#0000
000000#...#.........#.4...#00000
0000000#.3.#########.....#000000
00000000#...............#0000000
000000000###############00000000
00000000000000000000000000000000
