32
24
00000000000000000000000000000000
00000000000000000000000000000000
00000000000000000000000000000000
00000000000000000000000000000000
00000000000000000000000000000000
00000000000000000000000000000000
0000000000############0000000000
0000000000#...#.....4#0000000000
0000000000#1#.#.####.#0000000000
0000000000###.#....#.#0000000000
0000000000#....###.#.#0000000000
0000000000####.#s#.#.#0000000000
0000000000##5#.#.#.#.#0000000000
0000000000#........#.#0000000000
0000000000######.###.#0000000000
0000000000#3.....#2..#0000000000
0000000000############0000000000
00000000000000000000000000000000
00000000000000000000000000000000
00000000000000000000000000000000
00000000000000000000000000000000
00000000000000000000000000000000
00000000000000000000000000000000
00000000000000000000000000000000
