32
24
00000000000000000000000000000000
00000000000000000000000000000000
00000000000000000000000000000000
00000000000000000000000000000000
00000000000000000000000000000000
00000000000000000000000000000000
00############################00
00#..............#....1#.....#00
00#..####..#######..####..#..#00
00#.....#4.#..............#..#00
00####..####..#..####..####..#00
00#.....#.....#..#5.#.....#..#00
00#..####..#######..#######..#00
00#..#3....#........#........#00
00#..#######..#..####..#..####00
00#s..........#........#....2#00
00############################00
00000000000000000000000000000000
00000000000000000000000000000000
00000000000000000000000000000000
00000000000000000000000000000000
00000000000000000000000000000000
00000000000000000000000000000000
00000000000000000000000000000000