32
24
00000000000000000000000000000000
00000000000000000000000000000000
00000000000000000000000000000000
00000000000000000000000000000000
00000000000000000000000000000000
00000000000000000000000000000000
00000000000000000000000000000000
0000000###################000000
0000000###....#..........#000000
0000000###.###..########.#000000
0000000#...###.##..#####.#000000
0000000#.#####...#....##e#000000
0000000#.#######.####.####000000
0000000#.####....####....#000000
0000000#.####.##########.#000000
0000000#s................#000000
0000000###################000000
00000000000000000000000000000000
00000000000000000000000000000000
00000000000000000000000000000000
00000000000000000000000000000000
00000000000000000000000000000000
00000000000000000000000000000000
00000000000000000000000000000000
