32
24
00000000000000000000000000000000
00000000000000000000000000000000
00000000000000000000000000000000
00000000000000000000000000000000
00000000000000000000000000000000
00000000000000000000000000000000
00####################e#######00
00#..............#.....#.....#00
00#..####..#######..####..#..#00
00#.....#..#..............#..#00
00####..####..#..####..####..#00
00#.....#.....#..#..#.....#..#00
00#..####..#######..#######..#00
00#..#.....#........#........#00
00#..#######..#..####..#..####00
00#s..........#........#.....#00
00############################00
00000000000000000000000000000000
00000000000000000000000000000000
00000000000000000000000000000000
00000000000000000000000000000000
00000000000000000000000000000000
00000000000000000000000000000000
00000000000000000000000000000000