32
24
99999999999999999999999999999999
99999999999999999999999999999999
99999999999999999999999999999999
99999999999999999999999999999999
99999999999999999999999999999999
99999999999999999999999999999999
11111111111111111111111111111111
C0000000000000100000000000000001
10000000000000100000000000000001
10000000000000100000000000000001
10000000000000100000000000000001
11111111111110100000000000000001
10000000000000110000000000000001
10011110000000001000000000000001
11001011111111100000000000000001
10000000000000100000000000000001
10001000000000100000000000000001
11111111111111111111111111111111
99999999999999999999999999999999
99999999999999999999999999999999
99999999999999999999999999999999
99999999999999999999999999999999
99999999999999999999999999999999
99999999999999999999999999999999
0 7 7
1 8 8