32
24
99999999999999999999999999999999
99999999999999999999999999999999
99999999999999999999999999999999
99999999999999999999999999999999
99999999999999999999999999999999
99999999999999999999999999999999
99999999991111111111119999999999
99999999991000000000019999999999
99999999991011101111019999999999
99999999991000101111019999999999
99999999991000000000019999999999
99999999991010001000019999999999
99999999991011011000019999999999
99999999991011111111019999999999
99999999991011000100019999999999
99999999991010001101019999999999
99999999991000000000019999999999
99999999991111111111C19999999999
99999999999999999999999999999999
99999999999999999999999999999999
99999999999999999999999999999999
99999999999999999999999999999999
99999999999999999999999999999999
99999999999999999999999999999999
0 11 12
1 15 10
1 18 11
1 14 15
2 13 11
2 14 12
2 16 14