32
24
00000000000000000000000000000000
00000000000000000000000000000000
00000000000000000000000000000000
00000000000000000000000000000000
00000000000000000000000000000000
00000000000000000000000000000000
0000000000############0000000000
0000000000#...#......#0000000000
0000000000e.#.#.####.#0000000000
0000000000###.#....#.#0000000000
0000000000#....###.#.#0000000000
0000000000####.#s#.#.#0000000000
0000000000##.#.#.#.#.#0000000000
0000000000#........#.#0000000000
0000000000######.###.#0000000000
0000000000#......#...#0000000000
0000000000############0000000000
00000000000000000000000000000000
00000000000000000000000000000000
00000000000000000000000000000000
00000000000000000000000000000000
00000000000000000000000000000000
00000000000000000000000000000000
00000000000000000000000000000000
